................
....####........
....#..#........
....####........
................
