S..........##..E
....####...##...
....#..#...##...
....####...##...
................
