S.............##..E
.......####...##...
.......#..#...##...
.......####...##...
...................
...................